clear=清除
docElementAdditionalRules=附加规则
docElementAlignToPageBottom=对齐到页面底部
docElementBarWidth=条码宽度
docElementEditMultipleSelectionNotSupported=此设置不支持多选编辑
docElementErrorCorrectionLevel=纠错级别
docElementErrorCorrectionLevelHigh=高
docElementErrorCorrectionLevelLow=低
docElementErrorCorrectionLevelMedium=中
docElementErrorCorrectionLevelQuartile=四分位
docElementGuardBar=护栏
docElementImageCountExceeded=已达到允许的最大图像数量${count}
docElementLoadImageWebPErrorMsg=加载图像失败，请升级浏览器到最新版本
docElementOpacity=不透明度%
docElementRepeatGroupHeader=每页重复分组
docElementRichText=富文本
docElementRotate=旋转
docElementRotateDeg=旋转°
docElementShowInForeground=前景显示
docElementSpreadsheetPattern=模式
docElementSpreadsheetType=类型
docElementSpreadsheetTypeDate=日期
docElementSpreadsheetTypeNone=默认
docElementSpreadsheetTypeNumber=数字
editData=编辑
errorMsgAddtionalRulesNoStyleSelected=规则${info}未选择样式
errorMsgExternalImageNotAllowed=服务器不支持从外部资源加载图片
errorMsgGroupExpressionWithoutDataSource=分组表达式需要带数据源的表格
errorMsgInvalidRichTextFontNotAvailable=富文本包含服务器上不可用的字体
errorMsgInvalidRichTextParameter=富文本包含无效标签
errorMsgInvalidSpreadsheetDate=数据无法转换为日期，格式应为YYYY-MM-DD(或YYYY-MM-DD hh:MM表示带时间的日期)
errorMsgInvalidSpreadsheetNumber=数据无法转换为数字
errorMsgInvalidStringData=文本参数${info}的数据无效
errorMsgMissingGlyph=文本包含所选字体不可用的字符
errorMsgRepeatGroupHeaderAfterContent=内容行后分组不允许
errorMsgPlusVersionRequired=需要商业PLUS版本
parameterEditTestDataArrayNoFields=此列表未定义数据字段
parameterEditTestDataMapNoFields=此集合未定义数据字段
parameterTestDataImageInfo=图片会保存在报表模板中，可能会显著增加模板体积
parameterTestDataRichTextInfo=富文本可包含用于格式化的html标签。详见<a href="https://www.reportbro.com/doc/userguide#parameter_type_rich_text" target="_blank" rel="noreferrer">允许标签</a>
parameterTestDataRowCount=${count}行
parameterTestDataRowCountEmpty=空
parameterTestDataRowCountOne=1行
parameterTypeRichText=富文本
parametersDataSourceName=${name}参数
patternNumberGroupSymbol=千分位分隔符
patternNumberGroupSymbolInfo=留空为默认
plusFeatureInfo=需要商业<a href="https://www.reportbro.com/license/index" target="_blank" rel="noreferrer">PLUS版本</a>
plusFeatureInfoNestedParameter=嵌套参数需要商业<a href="https://www.reportbro.com/license/index" target="_blank" rel="noreferrer">PLUS版本</a>
popupWindowAddDataRow=添加行
styleType=元素类型
styleTypeFrame=框架
styleTypeImage=图像
styleTypeLine=线条
styleTypeSectionBand=节带
styleTypeTable=表格
styleTypeTableBand=表带
styleTypeText=文本
watermarkImages=图片水印
watermarkTexts=文字水印
watermarks=水印 